%%%%%
%   %
% P %
%.  %
%%%%%
